 For a Europe trip, you may want to write down the translations for "Where is the Bathroom?" in a notebook and carry your notebook with you.
 (Vay-say, bit-ay?) which means "water closet, please?"
Bulgarian = Къде е банята? ("Kade e banyata?")
Croatian= Oprostite, gdje je kupaonica? (j is pronounced y)
Czech = Prosim Vas, Kde jsou toalety?
Danish = Undskyld mig, hvor er badeværelset/toilettet? (oon-skool-MYE, voa eh bay-the-VAY-rell-seh / TOY-lett-eh?)
Dutch = Pardon, waar is de W.C. ("way say")?
English (British) = Excuse me, where is the toilet/loo/lavatory?
Esperanto = Pardonon, kie estas la banejo? (par-DOH-nohn, KEY-eh ESS-tahs la bahn-EY-yo?)
Estonian = Vabandage, kus on tualett?
French = pardon, où sont les toilettes? (pahr-DAW, oo saw lay twah-LETT?)
Gaelic (Irish) = Ca bhfuil an leithreas?
German = Wo ist die Toilette, bitte? (Vo ist dee toy-LETT-uh, BIT-uh?)
Greek = Parakalo, pou ine i tualetta? (Πού είναι η τουαλέτα;)
Hungarian= Elnézést, hol (van) a vécé? Icelandic = Hvar er salernið / klósettið? (Kvar er sal-erdnith / clow-set-ith? pronounce 'th' like in 'them')
Italian = Mi scusi, dov'è il bagno?
Latvian = Atvainojiet (sorry), kur ir tualete (Where is bathroom?
Lithuanian = Atsiprašau (excuse me), kur yra tualetas?
Maltese = Fejn qiegђed it-toilet? Neapolitan (Southwestern Italy) = scusat', arò stà 'o cesso?
Norwegian = Unnskyld meg,(pronounced oon-shyl) hvor er doen/toalettet (No pronunciation of the 't' at the end of toalette't', doen is slang said: doo-uhn) ?
Polish = Przepraszam, gdzie jest toaleta?
Portuguese = Por favor, onde é a casa-de-banho?
Romanian = Unde este toaleta, vă rog? (Oon-day yehs-tay twa-letta, vah rog?)
Russian = скажите пожалуйста, где туалет? (Skazhite pozhalusta, gde toalet?) listen

Serbian = Izvinite, gde je kupatilo?
Sinhalese(Sri Lankan) = Naana kaamaraya koheda?
Slovak = Prosím vás, kde sú toalety?
Slovene = Oprostite, kje je kopalnica/stranišče? (Kopalnica = bathroom, stranišče = toilet/rest room)
Swedish = Ursäkta mig (excuse me), var finns toaletten? (uhr-SHEHK-ta mey, var fins toa-letten?)
Spanish (Catalan) = On és el lavabo?
Ukrainian = Вибачте, де туалет? (Vybachte, de tualet?)
Welsh = Ble mae`r ty bach? (bleh MY-r Tee bach?)

