



Afrikaans: Dankie (standard).

Bengali: ধন্যবাদ (Dhon-no-baad).

Cambodian (Khmer): អរគុណ (Ar-Kun).

Cantonese: 多謝 (Doll jie).

Dutch: Dank u (formal). Dank je (informal).

Finnish: Kiitos.

French: Merci.

German: Vielen Dank (formal). Danke (informal).

Hebrew: Toda Raba.

Icelandic: Takk (Tahck).

Italian: Grazie.

Japanese: Domo arigato (formal). Arigato (informal).

Korean: Kam-Sam-Ni-Da.

Korean:고맙습니다 (Koh-mahp-soom-ni-da)

Krio: Tenki.

Latin: Gratias ago.

Malay: Terima kasih.

Malayalam: നന്ദി (Na-nni).

Mandarin Chinese: 谢谢 (Shyieh, Shyieh).

Norwegian: Takk/Tusen takk/Takk skal du ha.

Persian:متشکرم (moteshakkeram).

Portuguese: Obrigado (male)/obrigada(female).

Romanian: Multumesc (formal). Mersi (informal).

Russian: Спасибо (spa-SI-ba).

Serbian: Hvala.

Sindhi: Meherbaani. (مهرباني)

Sinhalese: Sthuthi.

Spanish: Gracias.

Swedish: Tack.

Tagalog/Filipino: Maraming salamat.

Tamil (தமிழ்): Nandri (நன்றி) .

Telugu: ధన్యవాదాలు (dhan-ya-vaadhalu).

Turkish: Teşekkürler.

Urdu: Shukriya (شکریہ).

Vietnamese: cám ơn (感恩);
