 You have several options and each has their drawbacks and strengths. Choose one of the following (for more information see the tips below).


Yerles - Gains extra skill points per level.
Eulderna - Resist magic.
Fairy - Strong magic but can't equip anything that's heavy.
Dwarf - Gem crafting and mining are their forte.
Juere - They don't get hungry very quickly.
Elea - Decent magic and bow ability's They are elves.
Snail - no skills, weakest selection.
Lich - Very strong magical spells but very ugly.
Goblin - Has the Eye of mind skill allowing them to do more damage.
Golem - immune to poison and has a high strength.
Mutant- Grows extra limbs every 3 levels.;
, This does not affect your character's skills.
 This determines your style of play. A complete guide could be written for each of these, but here is a summary. For more information, see the tips below.


Warrior - Uses swords and any armor and a shield.
Thief - Uses bows arrows and light armor, can also steal items.
Wizard - Light armor, magic spells and staffs.
Farmer - Uses scythes; skilled in gardening and genetic engineering.
Archer - Uses bows and leather armor (more efficient than thieves).
War Mage - Cross between a warrior and a wizard.
Tourist - Has no skills, but fishing and traveling.
Pianist - Has the ability to play music to gain money from people.
Priest - Uses Hammers and heavy armor can pray to banish curses.
Claymore - Uses Claymores and has a high defense and special magic skills.
 It's important to get a high charisma roll for the purpose of this guide followed by constitution and will.
 You can choose from Lucky 3x, Apprentice quartermaster or Accountant. This part is not crucial.
 This has no bearing on how you play but it's fun to have a cool alias. Select anything you like from the list then continue.
 Your appearance doesn't effect the game play but it's always nice to have a decent looking character.
 In this step you can determine the age of your character as well as other stats. Hit shift or esc to continue.
 Type any name and follow the prompt to continue

, It contains useful information and your character's backstory.
 He will ask you to kill several monsters. Pick up and use items and dig. Follow the in-game prompts as needed.
 Welcome to the world of Elona!Your next step is to leave the cave by heading south and head towards the town of Vernis. The game will provide a tutorial for the rest as needed.
