 in different languages.



Afrikaans: Ekskuus? / Kom weer? / Sê gou weer? / Wat het jy ge sê?

Bengali: আপনি কি বললেন? (aap ni ki bol len?) or simply (ki bol len?)

Cambodian (Khmer): អ្នកនិយាយអ្វី? (Nek-Niyay-Ar-Vey).

Cantonese: 你講乜嘢? (Nei gong mut yea?).

Dutch: "Wat zegt u?" or "Kunt u dat herhalen?"

Finnish: Mitä sanoitte?

French: Qu'est-ce que vous avez dit? Or simply Pardon?

German: Was haben Sie gesagt?

Hebrew: Ma Ata Amarta?

Icelandic: Hvad sagðirðu? (Kvath sahgthirthu?)

Japanese: Nan to ii mashita ka?

Krio: Wetin yu say?

Latin: Quid dixisti?

Malay: Apa yang telah kamu katakan?

Malayalam:ne entha paranje?

Mandarin Chinese: 你说了什么？ (Ni Shuo Le Shen Me?)

Norwegian: Hva sa du?

Persian:چی فرمودید؟(chi farmudid?)

Portuguese: O que é que disse?(formal)/ O que é que disseste?(informal)

Romanian: Ce ati/ai spus?

Russian: Что ты сказал? (Chto ti skazal?)

Serbian: та сте рекли?

Sindhi: Cha Chayo Tawhaan?

Sinhalese: Mokakda oya kiwwe?

Spanish: Repite, por favor.

Swedish: Vad sa du?

Tagalog/Filipino: Ano'ng sinabi mo? or Ano yung sinabi mo?

Telugu: yemannaru?

Tamil Enna sona?

Turkish: Ne dedin sen?

Urdu: Aap nay kia kaha?

