 in different languages.



Afrikaans: Waar is dit?

Bengali: এটা কোথায়? (eeta ko thay?)

Cambodian (Khmer): វានៅឯណា? (Vea-Nov-Ea-Na).

Cantonese: 邊度? (Bean duo?).

Dutch: Waar is het?

Finnish: Missä se on?

French: Où est-il ?

German: Wo ist es?

Hebrew: Eifo Ze?

Icelandic: Hvar er það? (Kvar ehr thadh?)

Japanese: Doko desu ka?

Korean: 어디? (eo-di?)

Krio: Na weh ee be?

Latin: Ubi id est?

Malay: Dimanakah ia?

Malayalam:athe evadaya

Mandarin Chinese: 哪儿 (Nar Yowe)

Norwegian: Hvor er det?

Portuguese: Onde é?

Romanian: Unde este?

Russian: Где это? (Gdye eta?)

Sindhi: Eho Kithey Ahey?

Sinhalese: Eka koheda thiyenne?

Spanish: ¿Donde está?

Swedish: Var är det?

Tagalog/Filipino: 'Asan na 'yon? or Nasaan na iyon?

Telugu: ఎక్కడ (yekkada)
Tamil: Atthu enga irruku

Turkish: Nerede?

Urdu: Wo Kahan Ha?

Vietnamese: ở đâu? (兜於)

